{
  "map_data": [
    [
      "00100",
      "00100",
      "00100",
      "00100",
      "00100",
      "00100",
      "00100",
      "00100",
      "00100",
      "00100",
      "00100",
      "00100",
      "00100",
      "00100",
      "00100"
    ],
    [
      "00100",
      "00100",
      "00400",
      "00300",
      "00500",
      "00400",
      "00700",
      "00200",
      "00700",
      "00100",
      "00100",
      "00100",
      "00100",
      "00100",
      "00100"
    ],
    [
      "00100",
      "00100",
      "00600",
      "00801",
      "00800",
      "00600",
      "00200",
      "00200",
      "00500",
      "00100",
      "00100",
      "00100",
      "00100",
      "00100",
      "00100"
    ],
    [
      "00100",
      "00100",
      "00200",
      "00200",
      "00400",
      "00200",
      "00200",
      "00500",
      "00500",
      "00100",
      "00100",
      "00100",
      "00100",
      "00100",
      "00100"
    ],
    [
      "00100",
      "00100",
      "00200",
      "00700",
      "00500",
      "00200",
      "00803",
      "00801",
      "00300",
      "00100",
      "00100",
      "00100",
      "00100",
      "00100",
      "00100"
    ],
    [
      "00100",
      "00100",
      "00600",
      "00200",
      "00803",
      "00400",
      "00800",
      "00400",
      "00200",
      "00100",
      "00100",
      "00100",
      "00100",
      "00100",
      "00100"
    ],
    [
      "00100",
      "00100",
      "00100",
      "00100",
      "00100",
      "00100",
      "00100",
      "00100",
      "00100",
      "00100",
      "00100",
      "00100",
      "00100",
      "00100",
      "00100"
    ],
    [
      "00100",
      "00100",
      "00100",
      "00100",
      "00100",
      "00100",
      "00100",
      "00100",
      "00100",
      "00100",
      "00100",
      "00100",
      "00100",
      "00100",
      "00100"
    ],
    [
      "00100",
      "00100",
      "00100",
      "00100",
      "00100",
      "00100",
      "00100",
      "00100",
      "00100",
      "00100",
      "00100",
      "00100",
      "00100",
      "00100",
      "00100"
    ],
    [
      "00100",
      "00100",
      "00100",
      "00100",
      "00100",
      "00100",
      "00100",
      "00100",
      "00100",
      "00100",
      "00100",
      "00100",
      "00100",
      "00100",
      "00100"
    ]
  ],
  "players": [
    {
      "direction": "down",
      "answer": {
        "x": 2,
        "y": 4
      }
    },
    {
      "direction": "down",
      "answer": {
        "x": 5,
        "y": 4
      }
    }
  ]
}