{
  "map_data": [
    [
      "00100",
      "00100",
      "00100",
      "00100",
      "00100",
      "00100",
      "00100",
      "00100",
      "00100",
      "00100",
      "00100",
      "00100",
      "00100",
      "00100",
      "00100"
    ],
    [
      "00100",
      "00100",
      "00100",
      "00600",
      "00200",
      "00200",
      "00500",
      "00200",
      "00200",
      "00200",
      "00200",
      "00100",
      "00100",
      "00100",
      "00100"
    ],
    [
      "00100",
      "00100",
      "00100",
      "00200",
      "00500",
      "00700",
      "00500",
      "00600",
      "00500",
      "00300",
      "00200",
      "00100",
      "00100",
      "00100",
      "00100"
    ],
    [
      "00100",
      "00100",
      "00100",
      "00300",
      "00803",
      "00802",
      "00801",
      "00803",
      "00802",
      "00801",
      "00700",
      "00100",
      "00100",
      "00100",
      "00100"
    ],
    [
      "00100",
      "00100",
      "00100",
      "00700",
      "00200",
      "00300",
      "00400",
      "00700",
      "00400",
      "00700",
      "00200",
      "00100",
      "00100",
      "00100",
      "00100"
    ],
    [
      "00100",
      "00100",
      "00100",
      "00200",
      "00500",
      "00700",
      "00700",
      "00700",
      "00700",
      "00600",
      "00200",
      "00100",
      "00100",
      "00100",
      "00100"
    ],
    [
      "00100",
      "00100",
      "00100",
      "00200",
      "00200",
      "00400",
      "00200",
      "00200",
      "00400",
      "00200",
      "00200",
      "00100",
      "00100",
      "00100",
      "00100"
    ],
    [
      "00100",
      "00100",
      "00100",
      "00100",
      "00100",
      "00100",
      "00100",
      "00100",
      "00100",
      "00100",
      "00100",
      "00100",
      "00100",
      "00100",
      "00100"
    ],
    [
      "00100",
      "00100",
      "00100",
      "00100",
      "00100",
      "00100",
      "00100",
      "00100",
      "00100",
      "00100",
      "00100",
      "00100",
      "00100",
      "00100",
      "00100"
    ],
    [
      "00100",
      "00100",
      "00100",
      "00100",
      "00100",
      "00100",
      "00100",
      "00100",
      "00100",
      "00100",
      "00100",
      "00100",
      "00100",
      "00100",
      "00100"
    ]
  ],
  "players": [
    {
      "direction": "up",
      "answer": {
        "x": 10,
        "y": 4
      }
    },
    {
      "direction": "up",
      "answer": {
        "x": 4,
        "y": 4
      }
    },
    {
      "direction": "up",
      "answer": {
        "x": 3,
        "y": 2
      }
    }
  ]
}