{
  "map_data": [
    [
      "00802",
      "00803",
      "00200",
      "00500",
      "00200",
      "00700",
      "00200",
      "00700",
      "00200",
      "00100",
      "00100",
      "00100",
      "00100",
      "00100",
      "00100"
    ],
    [
      "00500",
      "00700",
      "00800",
      "00500",
      "00500",
      "00700",
      "00700",
      "00200",
      "00802",
      "00100",
      "00100",
      "00100",
      "00100",
      "00100",
      "00100"
    ],
    [
      "00600",
      "00801",
      "00300",
      "00300",
      "00300",
      "00801",
      "00400",
      "00400",
      "00500",
      "00100",
      "00100",
      "00100",
      "00100",
      "00100",
      "00100"
    ],
    [
      "00200",
      "00600",
      "00400",
      "00700",
      "00500",
      "00400",
      "00803",
      "00800",
      "00200",
      "00100",
      "00100",
      "00100",
      "00100",
      "00100",
      "00100"
    ],
    [
      "00600",
      "00200",
      "00400",
      "00200",
      "00700",
      "00200",
      "00200",
      "00700",
      "00700",
      "00100",
      "00100",
      "00100",
      "00100",
      "00100",
      "00100"
    ],
    [
      "00100",
      "00100",
      "00100",
      "00100",
      "00100",
      "00100",
      "00100",
      "00100",
      "00100",
      "00100",
      "00100",
      "00100",
      "00100",
      "00100",
      "00100"
    ],
    [
      "00100",
      "00100",
      "00100",
      "00100",
      "00100",
      "00100",
      "00100",
      "00100",
      "00100",
      "00100",
      "00100",
      "00100",
      "00100",
      "00100",
      "00100"
    ],
    [
      "00100",
      "00100",
      "00100",
      "00100",
      "00100",
      "00100",
      "00100",
      "00100",
      "00100",
      "00100",
      "00100",
      "00100",
      "00100",
      "00100",
      "00100"
    ],
    [
      "00100",
      "00100",
      "00100",
      "00100",
      "00100",
      "00100",
      "00100",
      "00100",
      "00100",
      "00100",
      "00100",
      "00100",
      "00100",
      "00100",
      "00100"
    ],
    [
      "00100",
      "00100",
      "00100",
      "00100",
      "00100",
      "00100",
      "00100",
      "00100",
      "00100",
      "00100",
      "00100",
      "00100",
      "00100",
      "00100",
      "00100"
    ]
  ],
  "players": [
    {
      "direction": "left",
      "answer": {
        "x": 2,
        "y": 0
      }
    },
    {
      "direction": "right",
      "answer": {
        "x": 7,
        "y": 1
      }
    },
    {
      "direction": "down",
      "answer": {
        "x": 0,
        "y": 3
      }
    }
  ]
}