{
  "map_data": [
    [
      "00100",
      "00100",
      "00100",
      "00100",
      "00100",
      "00100",
      "00100",
      "00100",
      "00100",
      "00100",
      "00100",
      "00100",
      "00100",
      "00100",
      "00100"
    ],
    [
      "00100",
      "00100",
      "00100",
      "00700",
      "00500",
      "00600",
      "00200",
      "00500",
      "00200",
      "00100",
      "00100",
      "00100",
      "00100",
      "00100",
      "00100"
    ],
    [
      "00100",
      "00100",
      "00100",
      "00600",
      "00300",
      "00500",
      "00200",
      "00801",
      "00700",
      "00100",
      "00100",
      "00100",
      "00100",
      "00100",
      "00100"
    ],
    [
      "00100",
      "00100",
      "00100",
      "00600",
      "00200",
      "00200",
      "00200",
      "00200",
      "00400",
      "00100",
      "00100",
      "00100",
      "00100",
      "00100",
      "00100"
    ],
    [
      "00100",
      "00100",
      "00100",
      "00200",
      "00400",
      "00801",
      "00700",
      "00300",
      "00500",
      "00100",
      "00100",
      "00100",
      "00100",
      "00100",
      "00100"
    ],
    [
      "00100",
      "00100",
      "00100",
      "00100",
      "00100",
      "00100",
      "00100",
      "00100",
      "00100",
      "00100",
      "00100",
      "00100",
      "00100",
      "00100",
      "00100"
    ],
    [
      "00100",
      "00100",
      "00100",
      "00100",
      "00100",
      "00100",
      "00100",
      "00100",
      "00100",
      "00100",
      "00100",
      "00100",
      "00100",
      "00100",
      "00100"
    ],
    [
      "00100",
      "00100",
      "00100",
      "00100",
      "00100",
      "00100",
      "00100",
      "00100",
      "00100",
      "00100",
      "00100",
      "00100",
      "00100",
      "00100",
      "00100"
    ],
    [
      "00100",
      "00100",
      "00100",
      "00100",
      "00100",
      "00100",
      "00100",
      "00100",
      "00100",
      "00100",
      "00100",
      "00100",
      "00100",
      "00100",
      "00100"
    ],
    [
      "00100",
      "00100",
      "00100",
      "00100",
      "00100",
      "00100",
      "00100",
      "00100",
      "00100",
      "00100",
      "00100",
      "00100",
      "00100",
      "00100",
      "00100"
    ]
  ],
  "players": [
    {
      "direction": "left",
      "answer": {
        "x": 6,
        "y": 2
      }
    },
    {
      "direction": "right",
      "answer": {
        "x": 5,
        "y": 3
      }
    }
  ]
}