{
  "map_data": [
    [
      "00100",
      "00100",
      "00100",
      "00100",
      "00100",
      "00100",
      "00100",
      "00100",
      "00100",
      "00100",
      "00100",
      "00100",
      "00100",
      "00100",
      "00100"
    ],
    [
      "00100",
      "00100",
      "00100",
      "00400",
      "00500",
      "00200",
      "00700",
      "00700",
      "00100",
      "00100",
      "00100",
      "00100",
      "00100",
      "00100",
      "00100"
    ],
    [
      "00100",
      "00100",
      "00100",
      "00200",
      "00200",
      "00300",
      "00200",
      "00200",
      "00100",
      "00100",
      "00100",
      "00100",
      "00100",
      "00100",
      "00100"
    ],
    [
      "00100",
      "00100",
      "00100",
      "00500",
      "00200",
      "00800",
      "00800",
      "00700",
      "00100",
      "00100",
      "00100",
      "00100",
      "00100",
      "00100",
      "00100"
    ],
    [
      "00100",
      "00100",
      "00100",
      "00600",
      "00200",
      "00300",
      "00200",
      "00200",
      "00100",
      "00100",
      "00100",
      "00100",
      "00100",
      "00100",
      "00100"
    ],
    [
      "00100",
      "00100",
      "00100",
      "00200",
      "00600",
      "00500",
      "00400",
      "00400",
      "00100",
      "00100",
      "00100",
      "00100",
      "00100",
      "00100",
      "00100"
    ],
    [
      "00100",
      "00100",
      "00100",
      "00100",
      "00100",
      "00100",
      "00100",
      "00100",
      "00100",
      "00100",
      "00100",
      "00100",
      "00100",
      "00100",
      "00100"
    ],
    [
      "00100",
      "00100",
      "00100",
      "00100",
      "00100",
      "00100",
      "00100",
      "00100",
      "00100",
      "00100",
      "00100",
      "00100",
      "00100",
      "00100",
      "00100"
    ],
    [
      "00100",
      "00100",
      "00100",
      "00100",
      "00100",
      "00100",
      "00100",
      "00100",
      "00100",
      "00100",
      "00100",
      "00100",
      "00100",
      "00100",
      "00100"
    ],
    [
      "00100",
      "00100",
      "00100",
      "00100",
      "00100",
      "00100",
      "00100",
      "00100",
      "00100",
      "00100",
      "00100",
      "00100",
      "00100",
      "00100",
      "00100"
    ]
  ],
  "players": [
    {
      "direction": "right",
      "answer": {
        "x": 4,
        "y": 3
      }
    },
    {
      "direction": "up",
      "answer": {
        "x": 7,
        "y": 2
      }
    }
  ]
}